MODE 1
SIZE 9/11
LIMIT 0/30
COLOR LIMIT 5
STARS 5000/7500/8600
COLLECT COUNT 25/30
COLLECT ITEMS 1/4
10 10 10 10 10 10 10 10 10
10 10 10 10 10 10 10 10 10
14 10 10 10 10 10 10 10 14
00 14 10 10 10 10 10 14 00
00 00 14 10 10 10 14 00 00
00 00 00 14 14 14 00 00 00
00 00 10 10 10 10 10 00 00
00 10 17 17 17 17 17 10 00
10 10 17 10 10 10 17 10 10
10 10 17 10 10 10 17 10 10
10 10 17 17 17 17 17 10 10